[
  {
    "name": "brick",
    "uoNames": ["brick", "cobblestones"],
    "primaryTextureId": 1001,
    "textureIds": [
      1001, 1002, 1003, 1004, 1146, 1147, 1148, 1149, 1150, 1151, 1152, 1153, 1154, 1155, 1156,
      1157, 1167, 1168, 1169, 1170, 1171, 1172, 1173, 1174, 1175, 1176, 1177, 1178, 1179, 1180,
      1181, 1182, 1183, 1184, 1185, 1186, 1187, 1188, 1189, 1190, 1191, 1192, 1193, 1194, 1195,
      1196, 1197, 1198, 1367, 1368, 1369, 1370, 1371, 1372, 1373, 1374, 1375, 1376, 1377, 1378,
      1669, 1670, 1671, 1672, 1677, 1678, 1679, 1680, 1681, 1682, 1683, 1684, 1693, 1694, 1695, 1696
    ],
    "landTileIds": [
      1001, 1002, 1003, 1004, 1146, 1147, 1148, 1149, 1150, 1151, 1152, 1153, 1154, 1155, 1156,
      1157, 1167, 1168, 1169, 1170, 1171, 1172, 1173, 1174, 1175, 1176, 1177, 1178, 1179, 1180,
      1181, 1182, 1183, 1184, 1185, 1186, 1187, 1188, 1189, 1190, 1191, 1192, 1193, 1194, 1195,
      1196, 1197, 1198, 1367, 1368, 1369, 1370, 1371, 1372, 1373, 1374, 1375, 1376, 1377, 1378,
      1669, 1670, 1671, 1672, 1677, 1678, 1679, 1680, 1681, 1682, 1683, 1684, 1693, 1694, 1695, 1696
    ],
    "impassable": false,
    "isWater": false
  },
  {
    "name": "cave",
    "uoNames": ["cave", "cave exit", "obsidian"],
    "primaryTextureId": 581,
    "textureIds": [
      581, 582, 583, 584, 585, 586, 587, 588, 589, 590, 591, 592, 593, 594, 595, 596, 597, 598, 599,
      600, 601, 602, 603, 604, 605, 606, 607, 608, 609, 610, 611, 612, 613, 614, 615, 616, 617, 618,
      619, 620, 621, 700, 701, 702, 703, 704, 705, 706, 707, 708, 709, 710, 711, 712, 713, 714, 715,
      1595, 1596, 1597, 1598, 2100, 2101, 2102, 2103, 2104, 2105, 2241, 2242, 2243, 2244, 2245,
      2246, 16185, 16186, 16187, 16188, 16189, 16190, 16191, 16192, 16193, 16194, 16195, 16196,
      16197, 16198, 16199, 16200, 16201, 16202, 16203, 16204, 16205, 16206, 16207, 16208, 16209,
      16210, 16211, 16212, 16213, 16214, 16215, 16216, 16217, 16218, 16219, 16220, 16221, 16222,
      16223, 16224, 16225, 16226, 16227, 16228, 16229, 16230, 16231, 16232, 16258, 16259, 16260,
      16261, 16262, 16263, 16264, 16265, 16266, 16267, 16268, 16269, 16270, 16271, 16274, 16275,
      16276, 16277, 16278, 16279, 16280, 16281, 16282, 16283, 16284, 16285, 16286, 16287, 16288,
      16289, 16290, 16291, 16292, 16293, 16294, 16295, 16296, 16297, 16298, 16299, 16300, 16301,
      16302, 16303, 16304, 16305, 16306, 16307, 16308, 16309, 16310, 16311, 16312, 16313, 16314,
      16315, 16316, 16317, 16318, 16319, 16320, 16321, 16322, 16323, 16324, 16325, 16326, 16327,
      16328, 16329, 16330, 16331, 16332, 16333, 16334, 16335
    ],
    "landTileIds": [
      581, 582, 583, 584, 585, 586, 587, 588, 589, 590, 591, 592, 593, 594, 595, 596, 597, 598, 599,
      600, 601, 602, 603, 604, 605, 606, 607, 608, 609, 610, 611, 612, 613, 614, 615, 616, 617, 618,
      619, 620, 621, 700, 701, 702, 703, 704, 705, 706, 707, 708, 709, 710, 711, 712, 713, 714, 715,
      1595, 1596, 1597, 1598, 2028, 2029, 2030, 2031, 2032, 2033, 2100, 2101, 2102, 2103, 2104,
      2105, 16185, 16186, 16187, 16188, 16189, 16190, 16191, 16192, 16193, 16194, 16195, 16196,
      16197, 16198, 16199, 16200, 16201, 16202, 16203, 16204, 16205, 16206, 16207, 16208, 16209,
      16210, 16211, 16212, 16213, 16214, 16215, 16216, 16217, 16218, 16219, 16220, 16221, 16222,
      16223, 16224, 16225, 16226, 16227, 16228, 16229, 16230, 16231, 16232, 16258, 16259, 16260,
      16261, 16262, 16263, 16264, 16265, 16266, 16267, 16268, 16269, 16270, 16271, 16274, 16275,
      16276, 16277, 16278, 16279, 16280, 16281, 16282, 16283, 16284, 16285, 16286, 16287, 16288,
      16289, 16290, 16291, 16292, 16293, 16294, 16295, 16296, 16297, 16298, 16299, 16300, 16301,
      16302, 16303, 16304, 16305, 16306, 16307, 16308, 16309, 16310, 16311, 16312, 16313, 16314,
      16315, 16316, 16317, 16318, 16319, 16320, 16321, 16322, 16323, 16324, 16325, 16326, 16327,
      16328, 16329, 16330, 16331, 16332, 16333, 16334, 16335
    ],
    "impassable": true,
    "isWater": false
  },
  {
    "name": "dirt",
    "uoNames": ["dirt", "embank"],
    "primaryTextureId": 113,
    "textureIds": [
      113, 114, 115, 116, 117, 118, 119, 120, 121, 122, 123, 124, 130, 131, 133, 134, 135, 136, 137,
      138, 139, 140, 141, 142, 143, 144, 145, 146, 147, 148, 149, 150, 151, 152, 153, 154, 155, 156,
      157, 158, 159, 160, 161, 162, 163, 164, 165, 166, 167, 220, 221, 222, 223, 224, 225, 226, 227,
      232, 233, 234, 235, 321, 322, 323, 324, 332, 333, 334, 335, 361, 362, 363, 364, 365, 366, 367,
      368, 369, 370, 371, 372, 476, 477, 478, 479, 480, 481, 482, 483, 484, 485, 486, 487, 492, 493,
      494, 495, 626, 627, 628, 629, 638, 639, 640, 641, 720, 721, 722, 723, 724, 725, 726, 727, 741,
      742, 743, 744, 745, 746, 747, 748, 749, 750, 751, 752, 753, 754, 755, 756, 757, 758, 759, 760,
      761, 762, 763, 764, 765, 766, 767, 771, 772, 773, 774, 775, 776, 777, 778, 779, 780, 781, 782,
      783, 784, 785, 786, 787, 788, 789, 790, 791, 792, 793, 794, 795, 796, 797, 798, 799, 812, 813,
      814, 815, 829, 830, 831, 832, 837, 838, 839, 840, 841, 842, 843, 844, 853, 854, 855, 856, 871,
      872, 873, 874, 875, 876, 877, 878, 887, 888, 889, 890, 909, 910, 911, 912, 917, 918, 919, 920,
      921, 922, 923, 924, 933, 934, 935, 936, 1014, 1015, 1017, 1018, 1019, 1020, 1021, 1022, 1023,
      1024, 1025, 1026, 1027, 1028, 1029, 1351, 1352, 1353, 1354, 1355, 1356, 1357, 1358, 1363,
      1364, 1365, 1366, 1431, 1432, 1433, 1434, 1435, 1436, 1437, 1438, 1571, 1572, 1573, 1574,
      1575, 1576, 1577, 1578, 1579, 1580, 1581, 1582, 1583, 1584, 1585, 1586, 1587, 1588, 1589,
      1590, 1591, 1592, 1593, 1594, 1779, 1780, 1781, 1782, 1783, 1784, 1785, 1786, 1911, 1912,
      1913, 1914, 1915, 1916, 1917, 1918, 1919, 1920, 1921, 1922, 1923, 1924, 1925, 1926, 1927,
      1928, 1929, 1930, 1931, 1932, 1933, 1934, 1935, 1936, 1937, 2444, 2445, 2446, 2447, 2448,
      2449, 2450, 2451, 2452, 2453, 2454, 2455, 2456, 2457, 2458, 2459, 2460, 2461, 2462, 2463,
      2476, 2477, 2478, 2479, 2480, 2481, 2482, 2483, 2484, 2485, 2486, 2487, 2488, 2489, 2490,
      2491, 2492, 2493, 2494, 2495
    ],
    "landTileIds": [
      113, 114, 115, 116, 117, 118, 119, 120, 121, 122, 123, 124, 130, 131, 133, 134, 135, 136, 137,
      138, 139, 140, 141, 142, 143, 144, 145, 146, 147, 148, 149, 150, 151, 152, 153, 154, 155, 156,
      157, 158, 159, 160, 161, 162, 163, 164, 165, 166, 167, 220, 221, 222, 223, 224, 225, 226, 227,
      232, 233, 234, 235, 321, 322, 323, 324, 332, 333, 334, 335, 361, 362, 363, 364, 365, 366, 367,
      368, 369, 370, 371, 372, 476, 477, 478, 479, 480, 481, 482, 483, 484, 485, 486, 487, 492, 493,
      494, 495, 626, 627, 628, 629, 638, 639, 640, 641, 720, 721, 722, 723, 724, 725, 726, 727, 741,
      742, 743, 744, 745, 746, 747, 748, 749, 750, 751, 752, 753, 754, 755, 756, 757, 758, 759, 760,
      761, 762, 763, 764, 765, 766, 767, 771, 772, 773, 774, 775, 776, 777, 778, 779, 780, 781, 782,
      783, 784, 785, 786, 787, 788, 789, 790, 791, 792, 793, 794, 795, 796, 797, 798, 799, 812, 813,
      814, 815, 829, 830, 831, 832, 837, 838, 839, 840, 841, 842, 843, 844, 853, 854, 855, 856, 871,
      872, 873, 874, 875, 876, 877, 878, 887, 888, 889, 890, 909, 910, 911, 912, 917, 918, 919, 920,
      921, 922, 923, 924, 933, 934, 935, 936, 1014, 1015, 1017, 1018, 1019, 1020, 1021, 1022, 1023,
      1024, 1025, 1026, 1027, 1028, 1029, 1351, 1352, 1353, 1354, 1355, 1356, 1357, 1358, 1363,
      1364, 1365, 1366, 1431, 1432, 1433, 1434, 1435, 1436, 1437, 1438, 1571, 1572, 1573, 1574,
      1575, 1576, 1577, 1578, 1579, 1580, 1581, 1582, 1583, 1584, 1585, 1586, 1587, 1588, 1589,
      1590, 1591, 1592, 1593, 1594, 1779, 1780, 1781, 1782, 1783, 1784, 1785, 1786, 1911, 1912,
      1913, 1914, 1915, 1916, 1917, 1918, 1919, 1920, 1921, 1922, 1923, 1924, 1925, 1926, 1927,
      1928, 1929, 1930, 1931, 1932, 1933, 1934, 1935, 1936, 1937, 2444, 2445, 2446, 2447, 2448,
      2449, 2450, 2451, 2452, 2453, 2454, 2455, 2456, 2457, 2458, 2459, 2460, 2461, 2462, 2463,
      2476, 2477, 2478, 2479, 2480, 2481, 2482, 2483, 2484, 2485, 2486, 2487, 2488, 2489, 2490,
      2491, 2492, 2493, 2494, 2495
    ],
    "impassable": true,
    "isWater": false
  },
  {
    "name": "farmland",
    "uoNames": ["furrows"],
    "primaryTextureId": 9,
    "textureIds": [
      9, 10, 11, 12, 13, 14, 15, 16, 17, 18, 19, 20, 21, 336, 337, 338, 339, 340, 341, 342, 343,
      344, 345, 346, 347, 348
    ],
    "landTileIds": [
      9, 10, 11, 12, 13, 14, 15, 16, 17, 18, 19, 20, 21, 336, 337, 338, 339, 340, 341, 342, 343,
      344, 345, 346, 347, 348
    ],
    "impassable": false,
    "isWater": false
  },
  {
    "name": "forest",
    "uoNames": ["forest", "leaves", "tree"],
    "primaryTextureId": 196,
    "textureIds": [
      196, 197, 198, 199, 200, 201, 202, 203, 204, 205, 206, 207, 208, 209, 210, 211, 212, 213, 214,
      215, 237, 238, 239, 240, 241, 242, 243, 248, 249, 250, 251, 349, 350, 351, 352, 353, 354, 355,
      356, 357, 358, 359, 360, 804, 805, 806, 807, 808, 809, 810, 811, 1359, 1360, 1361, 1362, 1521,
      1522, 1523, 1524, 1529, 1530, 1531, 1532, 1533, 1534, 1535, 1536, 1537, 1538, 1539, 1540,
      1553, 1554, 1555, 1556, 1619, 1620, 1621, 1622, 1627, 1628, 1629, 1630, 1631, 1632, 1633,
      1634, 1643, 1644, 1645, 1646, 1711, 1712, 1713, 1714, 1715, 1716, 1723, 1724, 1725, 1726,
      1801, 1802, 1803, 1804, 1813, 1814, 1815, 1816, 1817, 1818, 1819, 1820, 11881, 11882, 11883,
      11884, 11885, 11886, 11887, 11888, 11889, 11890, 11891, 11892, 11893, 11894, 11895, 11896,
      11897, 11898, 11899, 11900, 11901, 11902, 11903, 11904, 11905, 11906, 11907, 11908, 11909,
      11910, 11911, 11912, 11913, 11914, 11915, 11916, 11917, 11918, 11919, 11920, 11921, 11922,
      11923, 11924, 11925, 11926, 11927, 11928, 11929, 11930, 11931, 11932, 11933, 11934, 11935,
      11936, 11937, 11938, 11939, 11940, 11941, 11942, 11943, 11944, 11945, 11946, 11947, 11948,
      11949, 11950, 11951, 11952, 11953, 11954, 11955, 11956, 11957, 11958, 11959, 11960, 11961,
      11962, 11963, 11964, 11965, 11966, 11967, 11968, 11969, 11970, 11971, 11972, 11973, 11974,
      11975, 11976, 11977, 11978, 11979, 11980, 11981, 11982, 11983, 11984, 11985, 11986, 11987,
      11988, 11989, 11990, 11991, 11992, 11993, 11994, 11995, 12000, 12001, 12002, 12003, 12004,
      12005, 12006, 12007, 12008, 12009, 12010, 12011, 12012, 12013, 12014, 12015, 12016, 12017,
      12018, 12019, 12020, 12021, 12022, 12023, 12024, 12025, 12026, 12027, 12028, 12029, 12030,
      12031, 12032, 12033, 12034, 12035, 12036, 12037, 12038, 12039, 12040, 12041, 12042, 12043,
      12044, 12045, 12046, 15088, 15089, 15090, 15091, 15092, 15093, 15094, 15095, 15096
    ],
    "landTileIds": [
      196, 197, 198, 199, 200, 201, 202, 203, 204, 205, 206, 207, 208, 209, 210, 211, 212, 213, 214,
      215, 237, 238, 239, 240, 241, 242, 243, 248, 249, 250, 251, 349, 350, 351, 352, 353, 354, 355,
      356, 357, 358, 359, 360, 804, 805, 806, 807, 808, 809, 810, 811, 1359, 1360, 1361, 1362, 1521,
      1522, 1523, 1524, 1529, 1530, 1531, 1532, 1533, 1534, 1535, 1536, 1537, 1538, 1539, 1540,
      1553, 1554, 1555, 1556, 1619, 1620, 1621, 1622, 1627, 1628, 1629, 1630, 1631, 1632, 1633,
      1634, 1643, 1644, 1645, 1646, 1711, 1712, 1713, 1714, 1715, 1716, 1723, 1724, 1725, 1726,
      1801, 1802, 1803, 1804, 1813, 1814, 1815, 1816, 1817, 1818, 1819, 1820, 11881, 11882, 11883,
      11884, 11885, 11886, 11887, 11888, 11889, 11890, 11891, 11892, 11893, 11894, 11895, 11896,
      11897, 11898, 11899, 11900, 11901, 11902, 11903, 11904, 11905, 11906, 11907, 11908, 11909,
      11910, 11911, 11912, 11913, 11914, 11915, 11916, 11917, 11918, 11919, 11920, 11921, 11922,
      11923, 11924, 11925, 11926, 11927, 11928, 11929, 11930, 11931, 11932, 11933, 11934, 11935,
      11936, 11937, 11938, 11939, 11940, 11941, 11942, 11943, 11944, 11945, 11946, 11947, 11948,
      11949, 11950, 11951, 11952, 11953, 11954, 11955, 11956, 11957, 11958, 11959, 11960, 11961,
      11962, 11963, 11964, 11965, 11966, 11967, 11968, 11969, 11970, 11971, 11972, 11973, 11974,
      11975, 11976, 11977, 11978, 11979, 11980, 11981, 11982, 11983, 11984, 11985, 11986, 11987,
      11988, 11989, 11990, 11991, 11992, 11993, 11994, 11995, 12000, 12001, 12002, 12003, 12004,
      12005, 12006, 12007, 12008, 12009, 12010, 12011, 12012, 12013, 12014, 12015, 12016, 12017,
      12018, 12019, 12020, 12021, 12022, 12023, 12024, 12025, 12026, 12027, 12028, 12029, 12030,
      12031, 12032, 12033, 12034, 12035, 12036, 12037, 12038, 12039, 12040, 12041, 12042, 12043,
      12044, 12045, 12046, 15088, 15089, 15090, 15091, 15092, 15093, 15094, 15095, 15096
    ],
    "impassable": true,
    "isWater": false
  },
  {
    "name": "grass",
    "uoNames": ["grass"],
    "primaryTextureId": 3,
    "textureIds": [
      3, 4, 5, 6, 59, 60, 61, 62, 125, 126, 127, 192, 193, 194, 195, 216, 217, 218, 219, 420, 421,
      422, 423, 561, 562, 563, 564, 569, 570, 571, 572, 573, 574, 575, 576, 577, 578, 579, 879, 880,
      881, 882, 883, 884, 885, 886, 891, 892, 893, 894, 959, 960, 961, 962, 963, 964, 965, 966, 971,
      972, 973, 974, 1401, 1402, 1403, 1404, 1405, 1406, 1407, 1408, 1419, 1420, 1495, 1496, 1497,
      1498, 1499, 1500, 1501, 1502, 1507, 1508, 1509, 1510, 1661, 1662, 1663, 1664, 1665, 1666,
      1667, 1668, 1673, 1674, 1675, 1676, 1685, 1686, 1687, 1688, 1689, 1690, 1691, 1692, 1697,
      1698, 1699, 1700, 1717, 1718, 1719, 1720, 1721, 1722, 1727, 1728, 1729, 1730, 1746, 1747,
      1748, 1749, 1750, 1751, 1752, 1753, 1758, 1759, 1760, 1761
    ],
    "landTileIds": [
      3, 4, 5, 6, 59, 60, 61, 62, 125, 126, 127, 192, 193, 194, 195, 216, 217, 218, 219, 420, 421,
      422, 423, 561, 562, 563, 564, 569, 570, 571, 572, 573, 574, 575, 576, 577, 578, 579, 879, 880,
      881, 882, 883, 884, 885, 886, 891, 892, 893, 894, 959, 960, 961, 962, 963, 964, 965, 966, 971,
      972, 973, 974, 1401, 1402, 1403, 1404, 1405, 1406, 1407, 1408, 1419, 1420, 1495, 1496, 1497,
      1498, 1499, 1500, 1501, 1502, 1507, 1508, 1509, 1510, 1661, 1662, 1663, 1664, 1665, 1666,
      1667, 1668, 1673, 1674, 1675, 1676, 1685, 1686, 1687, 1688, 1689, 1690, 1691, 1692, 1697,
      1698, 1699, 1700, 1717, 1718, 1719, 1720, 1721, 1722, 1727, 1728, 1729, 1730, 1746, 1747,
      1748, 1749, 1750, 1751, 1752, 1753, 1758, 1759, 1760, 1761
    ],
    "impassable": true,
    "isWater": false
  },
  {
    "name": "jungle",
    "uoNames": ["jungle"],
    "primaryTextureId": 172,
    "textureIds": [
      172, 173, 174, 175, 176, 179, 182, 185, 188, 189, 190, 191, 236, 252, 253, 254, 255, 256, 257,
      258, 259, 264, 265, 266, 267, 496, 497, 498, 499, 622, 623, 624, 625, 630, 631, 632, 633, 634,
      635, 636, 637, 646, 647, 648, 649, 658, 659, 660, 661, 1409, 1410, 1411, 1412, 1413, 1414,
      1415, 1416, 1417, 1418, 1421, 1422, 1423, 1424, 1439, 1440, 1441, 1442, 1443, 1444, 1445,
      1446, 1459, 1460, 1461, 1462, 1463, 1464, 1465, 1466, 1525, 1526, 1527, 1528, 1541, 1542,
      1543, 1544, 1545, 1546, 1547, 1548, 1549, 1550, 1551, 1552, 1557, 1558, 1559, 1560, 1831,
      1832, 1833, 1834, 1843, 1844, 1845, 1846, 1847, 1848, 1849, 1850
    ],
    "landTileIds": [
      172, 173, 174, 175, 176, 179, 182, 185, 188, 189, 190, 191, 236, 252, 253, 254, 255, 256, 257,
      258, 259, 264, 265, 266, 267, 496, 497, 498, 499, 622, 623, 624, 625, 630, 631, 632, 633, 634,
      635, 636, 637, 646, 647, 648, 649, 658, 659, 660, 661, 1409, 1410, 1411, 1412, 1413, 1414,
      1415, 1416, 1417, 1418, 1421, 1422, 1423, 1424, 1439, 1440, 1441, 1442, 1443, 1444, 1445,
      1446, 1459, 1460, 1461, 1462, 1463, 1464, 1465, 1466, 1525, 1526, 1527, 1528, 1541, 1542,
      1543, 1544, 1545, 1546, 1547, 1548, 1549, 1550, 1551, 1552, 1557, 1558, 1559, 1560, 1831,
      1832, 1833, 1834, 1843, 1844, 1845, 1846, 1847, 1848, 1849, 1850
    ],
    "impassable": true,
    "isWater": false
  },
  {
    "name": "lava",
    "uoNames": ["acid", "lava"],
    "primaryTextureId": 500,
    "textureIds": [
      500, 501, 502, 503, 11805, 11834, 11835, 11836, 11837, 11838, 11839, 11840, 11841, 11842,
      11843, 11844, 11845, 11846, 11847, 11848, 11849, 11850, 11851, 11852, 11853, 11854, 11855,
      11856, 11857, 11858, 11859, 11860, 11861, 11862, 11863, 11864, 11865, 11866, 11867, 11868,
      11869, 11870, 11871
    ],
    "landTileIds": [
      500, 501, 502, 503, 11790, 11791, 11805, 11806, 11818, 11819, 11820, 11821, 11822, 11823,
      11824, 11825, 11826, 11827, 11828, 11829, 11830, 11831, 11832, 11833, 11834, 11835, 11836,
      11837, 11838, 11839, 11840, 11841, 11842, 11843, 11844, 11845, 11846, 11847, 11848, 11849,
      11850, 11851, 11852, 11853, 11854, 11855, 11856, 11857, 11858, 11859, 11860, 11861, 11862,
      11863, 11864, 11865, 11866, 11867, 11868, 11869, 11870, 11871
    ],
    "impassable": true,
    "isWater": true
  },
  {
    "name": "sand",
    "uoNames": ["sand"],
    "primaryTextureId": 22,
    "textureIds": [
      22, 23, 24, 25, 26, 27, 28, 29, 30, 31, 32, 33, 34, 35, 36, 37, 38, 39, 40, 41, 42, 43, 44,
      45, 46, 47, 48, 49, 50, 51, 52, 53, 54, 55, 56, 57, 58, 68, 69, 70, 71, 72, 73, 74, 75, 286,
      287, 288, 289, 294, 295, 296, 297, 298, 299, 300, 301, 424, 425, 426, 427, 441, 442, 443, 444,
      445, 446, 447, 448, 449, 450, 451, 452, 453, 454, 455, 456, 457, 458, 459, 460, 461, 462, 463,
      464, 465, 642, 643, 644, 645, 650, 651, 652, 653, 654, 655, 656, 657, 821, 822, 823, 824, 825,
      826, 827, 828, 833, 834, 835, 836, 845, 846, 847, 848, 849, 850, 851, 852, 857, 858, 859, 860,
      951, 952, 953, 954, 955, 956, 957, 958, 967, 968, 969, 970, 1447, 1448, 1449, 1450, 1451,
      1452, 1453, 1454, 1455, 1456, 1457, 1458, 1611, 1612, 1613, 1614, 1615, 1616, 1617, 1618,
      1623, 1624, 1625, 1626, 1635, 1636, 1637, 1638, 1639, 1640, 1641, 1642, 1647, 1648, 1649, 1650
    ],
    "landTileIds": [
      22, 23, 24, 25, 26, 27, 28, 29, 30, 31, 32, 33, 34, 35, 36, 37, 38, 39, 40, 41, 42, 43, 44,
      45, 46, 47, 48, 49, 50, 51, 52, 53, 54, 55, 56, 57, 58, 68, 69, 70, 71, 72, 73, 74, 75, 286,
      287, 288, 289, 294, 295, 296, 297, 298, 299, 300, 301, 424, 425, 426, 427, 441, 442, 443, 444,
      445, 446, 447, 448, 449, 450, 451, 452, 453, 454, 455, 456, 457, 458, 459, 460, 461, 462, 463,
      464, 465, 642, 643, 644, 645, 650, 651, 652, 653, 654, 655, 656, 657, 821, 822, 823, 824, 825,
      826, 827, 828, 833, 834, 835, 836, 845, 846, 847, 848, 849, 850, 851, 852, 857, 858, 859, 860,
      951, 952, 953, 954, 955, 956, 957, 958, 967, 968, 969, 970, 1447, 1448, 1449, 1450, 1451,
      1452, 1453, 1454, 1455, 1456, 1457, 1458, 1611, 1612, 1613, 1614, 1615, 1616, 1617, 1618,
      1623, 1624, 1625, 1626, 1635, 1636, 1637, 1638, 1639, 1640, 1641, 1642, 1647, 1648, 1649, 1650
    ],
    "impassable": true,
    "isWater": false
  },
  {
    "name": "sandstone",
    "uoNames": ["sand stone"],
    "primaryTextureId": 1094,
    "textureIds": [
      1094, 1095, 1096, 1097, 1098, 1099, 1100, 1101, 1102, 1103, 1104, 1105, 1106, 1107, 1108,
      1109, 1110, 1111, 1112, 1113, 1114, 1115, 1116, 1117, 1118, 1119, 1120, 1121, 1122, 1123,
      1124, 1125, 1126, 1127, 1128, 1129, 1130, 1131, 1132, 1133, 1134, 1135, 1136, 1137, 1138,
      1139, 1140, 1141, 1142, 1143, 1144, 1145
    ],
    "landTileIds": [
      1094, 1095, 1096, 1097, 1098, 1099, 1100, 1101, 1102, 1103, 1104, 1105, 1106, 1107, 1108,
      1109, 1110, 1111, 1112, 1113, 1114, 1115, 1116, 1117, 1118, 1119, 1120, 1121, 1122, 1123,
      1124, 1125, 1126, 1127, 1128, 1129, 1130, 1131, 1132, 1133, 1134, 1135, 1136, 1137, 1138,
      1139, 1140, 1141, 1142, 1143, 1144, 1145
    ],
    "impassable": false,
    "isWater": false
  },
  {
    "name": "snow",
    "uoNames": ["snow"],
    "primaryTextureId": 268,
    "textureIds": [
      268, 269, 270, 271, 276, 277, 278, 279, 282, 283, 284, 285, 302, 303, 304, 305, 377, 378, 379,
      380, 381, 382, 383, 384, 385, 386, 387, 388, 389, 390, 391, 392, 393, 394, 901, 902, 903, 904,
      905, 906, 907, 908, 913, 914, 915, 916, 925, 926, 927, 928, 929, 930, 931, 932, 937, 938, 939,
      940, 1471, 1472, 1473, 1474, 1475, 1476, 1477, 1478, 1479, 1480, 1481, 1482, 1483, 1484, 1485,
      1486, 1487, 1488, 1489, 1490, 1491, 1492, 1493, 1494, 1503, 1504, 1505, 1506, 1861, 1862,
      1863, 1864, 1873, 1874, 1875, 1876, 1877, 1878, 1879, 1880, 1885, 1886, 1887, 1888, 1901,
      1902, 1903, 1904, 1905, 1906, 1907
    ],
    "landTileIds": [
      268, 269, 270, 271, 276, 277, 278, 279, 282, 283, 284, 285, 302, 303, 304, 305, 377, 378, 379,
      380, 381, 382, 383, 384, 385, 386, 387, 388, 389, 390, 391, 392, 393, 394, 901, 902, 903, 904,
      905, 906, 907, 908, 913, 914, 915, 916, 925, 926, 927, 928, 929, 930, 931, 932, 937, 938, 939,
      940, 1471, 1472, 1473, 1474, 1475, 1476, 1477, 1478, 1479, 1480, 1481, 1482, 1483, 1484, 1485,
      1486, 1487, 1488, 1489, 1490, 1491, 1492, 1493, 1494, 1503, 1504, 1505, 1506, 1861, 1862,
      1863, 1864, 1873, 1874, 1875, 1876, 1877, 1878, 1879, 1880, 1885, 1886, 1887, 1888, 1901,
      1902, 1903, 1904, 1905, 1906, 1907
    ],
    "impassable": true,
    "isWater": false
  },
  {
    "name": "stone",
    "uoNames": ["flagstone", "marble", "stone", "stone moss", "stone moss2"],
    "primaryTextureId": 1078,
    "textureIds": [
      513, 514, 515, 516, 1078, 1079, 1080, 1081, 1082, 1083, 1084, 1085, 1086, 1087, 1088, 1089,
      1090, 1091, 1092, 1093, 1158, 1159, 1160, 1161, 1257, 1258, 1259, 1260, 1261, 1262, 1263,
      1264, 1265, 1266, 15942, 15943, 15944, 15945, 15946, 15947, 15948, 15949, 15950, 15951, 15952,
      15953, 15954, 15955, 15956, 15957, 15958, 15959, 15960, 15961, 15962, 15963, 15964, 15965,
      15966, 15967, 15968, 15969, 15970, 15971, 15972, 15973
    ],
    "landTileIds": [
      513, 514, 515, 516, 1078, 1079, 1080, 1081, 1082, 1083, 1084, 1085, 1086, 1087, 1088, 1089,
      1090, 1091, 1092, 1093, 1158, 1159, 1160, 1161, 1257, 1258, 1259, 1260, 1261, 1262, 1263,
      1264, 1265, 1266, 15942, 15943, 15944, 15945, 15946, 15947, 15948, 15949, 15950, 15951, 15952,
      15953, 15954, 15955, 15956, 15957, 15958, 15959, 15960, 15961, 15962, 15963, 15964, 15965,
      15966, 15967, 15968, 15969, 15970, 15971, 15972, 15973
    ],
    "impassable": false,
    "isWater": false
  },
  {
    "name": "tile",
    "uoNames": ["tile"],
    "primaryTextureId": 1046,
    "textureIds": [
      1046, 1047, 1048, 1049, 1050, 1051, 1052, 1053, 1054, 1055, 1056, 1057, 1058, 1059, 1060,
      1061, 1062, 1063, 1064, 1065, 1066, 1067, 1068, 1069, 1070, 1071, 1072, 1073, 1074, 1075,
      1076, 1077, 1162, 1163, 1164, 1165, 1166
    ],
    "landTileIds": [
      1046, 1047, 1048, 1049, 1050, 1051, 1052, 1053, 1054, 1055, 1056, 1057, 1058, 1059, 1060,
      1061, 1062, 1063, 1064, 1065, 1066, 1067, 1068, 1069, 1070, 1071, 1072, 1073, 1074, 1075,
      1076, 1077, 1162, 1163, 1164, 1165, 1166
    ],
    "impassable": false,
    "isWater": false
  },
  {
    "name": "water",
    "uoNames": ["water"],
    "primaryTextureId": 310,
    "textureIds": [310, 311],
    "landTileIds": [168, 169, 170, 171, 310, 311],
    "impassable": true,
    "isWater": true
  },
  {
    "name": "wood",
    "uoNames": ["planks", "wooden floor"],
    "primaryTextureId": 662,
    "textureIds": [
      662, 663, 664, 665, 666, 667, 668, 669, 670, 671, 672, 673, 674, 675, 676, 677, 678, 679, 680,
      681, 682, 683, 684, 685, 686, 687, 688, 689, 690, 691, 692, 693, 694, 695, 696, 697, 698, 699,
      1030, 1031, 1032, 1033, 1034, 1035, 1036, 1037, 1038, 1039, 1040, 1041, 1042, 1043, 1044,
      1045, 1203, 1204, 1205, 1206, 1207, 1208, 1209, 1210, 1211, 1212, 1213, 1214, 1215, 1216,
      1217, 1218, 1219, 1220, 1221, 1222, 1227, 1228, 1229, 1230, 1231, 1232, 1233, 1234, 1235,
      1236, 1237, 1240, 1241, 1242, 1243, 1244, 1246, 1249
    ],
    "landTileIds": [
      662, 663, 664, 665, 666, 667, 668, 669, 670, 671, 672, 673, 674, 675, 676, 677, 678, 679, 680,
      681, 682, 683, 684, 685, 686, 687, 688, 689, 690, 691, 692, 693, 694, 695, 696, 697, 698, 699,
      1030, 1031, 1032, 1033, 1034, 1035, 1036, 1037, 1038, 1039, 1040, 1041, 1042, 1043, 1044,
      1045, 1203, 1204, 1205, 1206, 1207, 1208, 1209, 1210, 1211, 1212, 1213, 1214, 1215, 1216,
      1217, 1218, 1219, 1220, 1221, 1222, 1227, 1228, 1229, 1230, 1231, 1232, 1233, 1234, 1235,
      1236, 1237, 1240, 1241, 1242, 1243, 1244, 1246, 1249
    ],
    "impassable": false,
    "isWater": false
  }
]
